Ameliorate - Make (something bad or unsatisfactory) better
Fierce - Having or displaying an intense or ferocious aggressiveness
Boisterous - (of a person, event, or behavior) noisy, energetic, and cheerful
Ascertain - Find (something) out for certain; make sure of
Conspiracy - A secret plan by a group to do something unlawful or harmful
Exacerbate - Make (a problem, bad situation, or negative feeling) worse 
Executive - Having the power to put plans, actions, or laws into effect
Constitution - A body of fundamental principles or established precedents according to which a state or other organization is acknowledged to be governed
Prophetic - Accurately describing or predicting what will happen in the future
Confession - A formal statement admitting that one is guilty of a crime
Normal - conforming to a standard; usual, typical, or expected
Enthusiasm - Intense and eager enjoyment, interest, or approval
Virtual - Almost or nearly as described, but not completely or according to strict definition
Stewardess - A woman who is employed to provide meals for and otherwise look after the passengers on a ship or aircraft
Typical - Conforming to a standard; usual, typical, or expected
Consistent - (of a person, behavior, or process) unchanging in achievement or effect over a period of time
Deteriorate - Become progressively worse
Polemical - Of, relating to, or involving strongly critical, controversial, or disputatious writing or speech
Effective - Successful in producing a desired or intended result
Mitigate - Make (something bad or unsatisfactory) better
Fastidious - Very attentive to and concerned about accuracy and detail
Delicious - Highly pleasant to the taste
Curiosity - A strong desire to know or learn something
Novel - (a.) Of recent origin or introduction; not ancient; new; hence, out of the ordinary course; unusual; strange; surprising.
Bogus - Not genuine or true; fake
Tasty - Highly pleasant to the taste
Alleviate - Make (something bad or unsatisfactory) better
Delightful - Pleasing in general; delightful
Contemporary - Living or occurring at the same time
Obsolete - No longer produced or used; out of date
Engage - Occupy, attract, or involve (someone's interest or attention)
Interest - A strong desire to know or learn something
Fresh - Not previously known or used; new or different
Yummy - Highly pleasant to the taste
Hostess - A woman who is employed to provide meals for and otherwise look after the passengers on a ship or aircraft
Sweet - Pleasing in general; delightful
Fanciful - (of a person or their thoughts and ideas) overimaginative and unrealistic
Tolerance - The ability or willingness to tolerate something, in particular the existence of opinions or behavior that one does not necessarily agree with
Frugality - The quality of being economical with money or food
Stinginess - Reluctant to part with money or goods
Overshadow - Tower above and cast a shadow over
Temperance - Abstinence from alcoholic drink
Tumultuous - Making a loud, confused noise
Passionate - Showing or caused by strong feelings or a strong belief
Eminence - Fame or recognized superiority, especially within a particular sphere or profession
Notoriety - The state of being famous or well known for some bad quality or deed
Precarious - Not securely held or in position; dangerously likely to fall or collapse
Orthodox - (of a person or their views, especially religious or political ones, or other beliefs or practices) conforming to what is generally or traditionally accepted as right or true; established and approved
Eccentric - (of a person or their behavior) unconventional and slightly strange
Amorous - Showing, feeling, or relating to sexual desire
Conventional - Conforming to a standard; usual, typical, or expected
Innovation - (n.) The act of innovating; introduction of something new, in customs, rites, etc.
Acerbic - (especially of a comment or style of speaking) sharp and forthright
Meticulous - Howing great attention to detail; very careful and precise
Restive - (of a person) unable to keep still or silent and becoming increasingly difficult to control, especially because of impatience, dissatisfaction, or boredom
Mysterious - Difficult or impossible to understand, explain, or identify
Fortuitous - Happening by accident or chance rather than design
Indecorous - Not in keeping with good taste and propriety 
Rational - Based on or in accordance with reason or logic
Flexibility - The quality of bending easily without breaking
Diffidence - Modesty or shyness resulting from a lack of self-confidence
Prolixity - Extended to great, unnecessary, or tedious length
Austerity - Ternness or severity of manner or attitude
Taciturnity - The trait of reticence, of seeming aloof and uncommunicative
Volubility - The quality of talking fluently, readily, or incessantly
Pellucid - translucently clear
Complementary - Combining in such a way as to enhance or emphasize the qualities of each other or another
Bolster - Support or strengthen; prop up
Aloof - Not friendly or forthcoming; cool and distant
Placid - (of a person or animal) not easily upset or excited
Skittish - (of a person) unable to keep still or silent and becoming increasingly difficult to control, especially because of impatience, dissatisfaction, or boredom
Endeavor - Try hard to do or achieve something
Conference - A formal meeting for discussion
Research - The systematic investigation into and study of materials and sources in order to establish facts and reach new conclusions
Cursory - Hasty and therefore not thorough or detailed
Conversation - The informal exchange of ideas by spoken words
Dialogue - The informal exchange of ideas by spoken words
Concisely - Expressing or covering much in few words
Reference - The action of mentioning or alluding to something
Bibliographical - A list of the written sources of information on a subject
Advisor - A person who gives advice, typically someone who is expert in a particular field
Criticism - Of, relating to, or involving strongly critical, controversial, or disputatious writing or speech
Critical - Very attentive to and concerned about accuracy and detail
Hard - Solid, firm, and resistant to pressure; not easily broken, bent, or pierced
Argument - An exchange of diverging or opposite views, typically a heated or angry one
Galaxy - A system of millions or billions of stars, together with gas and dust, held together by gravitational attraction
Majesty - Impressive stateliness